a: 阿啊哎哀唉埃挨癌矮蔼爱碍安岸按案暗昂凹熬傲奥澳腌吖锕嗄
ba: 八巴扒吧疤拔跋把坝爸罢霸掰白百柏摆败拜斑班搬板版办半伴扮瓣邦帮膀傍棒包胞雹宝饱保堡报抱暴爆杯悲碑北贝备背倍被辈奔本笨崩绷蹦逼鼻比彼笔鄙币必毕闭庇毙秘弊碧蔽壁避臂边编鞭扁便变遍辨辩辫标彪膘表憋别宾滨冰兵丙柄饼并病拨波玻剥脖菠伯驳泊博搏膊薄卜补捕不布步怖部魃粑笆钯
cai: 猜才材财裁采彩睬踩菜参餐残蚕惭惨灿仓苍舱藏操糙槽草册侧厕测策层曾叉插查察茬茶搽差拆柴豺搀掺馋缠蝉产铲阐颤昌长肠尝常偿厂场敞畅倡唱抄钞超巢朝嘲潮吵炒车扯彻撤尘臣沉辰陈晨闯衬称趁撑成呈诚承城乘惩程澄橙逞秤吃痴持池迟驰耻齿斥赤翅充冲虫崇宠抽仇绸愁稠筹酬丑臭出初除厨锄础储楚处触川穿传船喘串疮窗床创吹炊垂锤春纯唇淳醇蠢戳绰词祠慈辞磁雌此次刺赐匆葱聪从丛凑粗促醋簇窜篡催摧脆粹翠村存寸搓措错偲骖粲
da: 搭达答打大呆歹代带待怠贷袋逮戴丹单担耽胆旦但诞弹淡蛋当挡党荡档刀叨导岛倒蹈到悼盗道稻得德的灯登等瞪凳低堤滴迪敌笛底抵地弟帝递第颠典点电佃店垫淀殿刁叼雕吊钓调掉爹跌叠蝶丁叮盯钉顶订定丢东冬董懂动冻栋洞都兜抖斗陡豆逗都督毒读独堵赌杜肚度渡端短段断缎煅锻堆队对兑吨敦蹲盾顿多夺朵躲耷哒嗒鞑
e: 俄鹅额恶饿遏恩儿而尔耳二贰婀轭迩
fa: 发乏伐罚阀筏法帆番翻凡烦繁反返犯饭泛范贩方坊芳防妨房仿访纺放飞非啡肥匪诽吠肺废沸费分芬吩纷氛坟焚粉份奋愤粪丰风封疯峰锋蜂逢缝讽凤奉佛否夫敷肤伏扶拂服俘浮符幅福抚甫府斧俯辅腐父付负妇附咐复赴副傅富腹覆砝
ga: 尬该改盖概钙干甘杆肝竿秆赶敢感干冈刚纲缸钢岗港杠高膏篙糕搞稿告哥歌搁割革葛格隔个各给根跟更耕工弓公功攻供宫恭躬巩拱共贡勾沟钩狗构购够估咕孤姑古谷股骨鼓固故顾雇瓜刮挂乖拐怪关观官冠棺馆管贯惯灌罐光广归龟规闺轨鬼柜贵桂跪滚棍国果过尕旮
ha: 哈孩海害酣含函寒喊罕汉汗旱悍焊憾撼行航巷毫豪好号浩耗呵喝合何和河核荷盒贺黑嘿痕很狠恨哼恒横衡轰哄烘红宏洪虹鸿侯喉猴吼后厚候乎呼忽狐胡壶湖糊虎互户护花华哗滑猾化划画话怀槐坏欢还环缓幻唤换患焕疾豢慌皇黄煌晃谎灰挥恢辉回毁悔汇会讳绘贿秽惠慧昏婚浑魂混豁活火伙或货获祸惑铪氦劾
ji: 击饥圾机肌鸡迹积基绩激及吉级即极急疾集籍几己挤脊计记纪忌技际剂季既济继寄寂加夹佳家嘉甲钾价驾架假嫁稼奸尖坚间肩艰兼监煎拣俭柬捡检减剪简见件建剑荐贱健舰渐溅鉴键箭江将姜浆僵疆讲奖匠降酱交郊浇骄娇胶教焦嚼角狡脚搅缴叫轿较觉阶皆接揭街节劫杰洁结捷截竭姐解介戒届界借巾斤今金津筋仅紧锦谨尽劲近进晋浸禁京经茎惊晶睛精井颈景警净径竞竟敬境静镜纠究九久酒旧救就舅居拘鞠局菊橘举矩句巨拒具剧惧据距锯聚捐卷倦绢决绝觉掘嚼军君均菌俊峻骏丌乩剞掎彐麂
ka: 咖卡开揩凯慨刊堪砍看康慷糠扛抗炕考烤靠科棵颗壳咳可渴克刻客课肯垦恳坑空孔恐控抠口扣枯哭苦库裤酷夸跨挎块快宽款匡筐狂况矿框旷亏窥葵魁愧溃昆困括阔咔佧胩
la: 垃拉啦喇腊蜡辣来莱赖蓝栏拦篮览懒烂滥郎狼廊朗浪捞劳牢老佬姥涝乐勒雷垒泪类累冷厘梨离璃黎礼李里理鲤力历厉立丽利励例隶俩连帘怜莲联廉脸练炼恋链良凉梁粮两亮谅辆量辽疗聊僚了料列劣烈猎裂邻林临淋磷灵铃陵零龄领令另溜刘留流硫榴柳六龙聋隆垄拢笼弄楼搂漏露卢芦炉鲁陆录鹿碌路驴旅屡律虑绿滤剌邋旯
ma: 妈麻马玛码蚂骂吗埋买麦卖迈脉瞒满曼慢漫忙芒盲茫猫毛矛茅茂冒贸帽貌么没眉梅媒煤霉每美妹门闷们萌盟猛梦眯弥迷谜米秘觅密蜜眠绵棉免勉面苗描瞄秒妙庙灭民敏名明鸣命谬摸模膜摩磨抹末没莫墨默谋某母亩牡姆拇木目牧墓幕慕暮穆祃犸杩
na: 拿哪那纳钠乃奶耐男南难囊挠恼脑闹呢内嫩能妮泥你拟逆年念娘酿鸟尿捏您宁凝牛扭纽农浓弄奴努怒女暖虐挪诺捺肭衲
ou: 欧鸥殴偶藕呕沤耦怄瓯
pa: 趴爬帕怕拍排牌派攀盘判叛盼乓庞旁胖抛炮袍跑泡呸陪培赔佩配喷盆砰抨烹朋棚蓬硼鹏捧碰批披劈皮疲匹痞僻屁譬片偏篇骗飘漂票撇拼贫频品聘乒平评凭苹瓶萍坡泼婆迫破魄剖扑铺仆葡朴普谱瀑筢
qi: 七妻凄戚期欺漆齐其奇歧骑棋旗乞企岂启起气迄弃汽契砌器恰洽千迁牵铅谦签前钱钳潜浅遣欠款枪腔强墙抢悄敲锹桥瞧巧切茄且窃亲侵芹琴禽勤青氢轻倾清情晴顷请庆穷丘秋求球区曲驱屈趋渠取娶去趣圈权全泉拳犬劝券缺却雀确鹊俟汔碛葺
ran: 然燃染嚷壤让饶扰绕惹热人仁忍认任扔仍日绒荣容熔融冗柔揉肉如儒乳辱入软锐瑞润若弱苒蚺髯
sa: 撒洒萨塞赛三散桑嗓丧搔骚扫嫂色涩森僧杀沙纱傻啥筛晒山删衫闪陕扇善伤商裳晌赏上尚捎梢烧稍勺少哨舌蛇舍设社射涉摄申伸身深神审婶肾甚渗慎升生声性牲胜绳省圣盛剩尸失师诗施狮湿十石时识实拾蚀食史使始驶士氏世示市式似事势侍饰试视柿是适室逝释收手守首寿受兽售授瘦书叔殊梳疏舒输蔬熟暑属鼠数术束述树竖恕刷衰摔甩帅栓双霜爽谁水税睡顺说司丝私思斯撕死四寺似饲肆松宋送诵搜艘苏俗诉肃素速宿塑酸蒜算虽随岁碎穗孙损笋缩所索锁卅挲脎
ta: 他它她塌塔踏台抬太态泰贪摊滩坛谈痰潭坦叹炭探叹汤唐堂塘膛糖倘躺趟涛掏滔逃桃陶淘讨套特藤腾疼梯踢啼提题蹄体替天添田甜填挑条跳贴铁厅听烃廷亭庭停挺艇通同铜童统痛偷头投透凸秃突图徒途涂屠土吐兔团推腿退吞屯托拖脱驼妥拓唾溻獭鳎
wa: 挖哇蛙娃瓦歪外弯湾丸完玩顽挽晚碗万汪亡王网往忘旺望危威微为围违唯维伟韦伪尾纬委萎卫未位味畏胃喂慰温文纹闻蚊稳问翁嗡窝我沃卧握乌污屋无吴吾五午伍武侮舞务物误悟雾腽娲畖
xi: 夕西吸希昔析息牺悉惜稀溪锡熄熙蜥嘻膝习席袭媳洗喜戏系细隙虾瞎峡狭霞下夏吓仙先纤掀鲜闲弦咸衔嫌显险县现限线宪陷馅羡献乡相香厢湘箱详祥翔享响想向巷项象像橡削消宵萧销小晓孝校笑效些歇协邪胁斜谐携鞋写泄泻卸屑械谢心辛欣新薪信兴星腥刑行形型醒杏姓幸性兄凶胸匈雄熊休修羞朽秀绣袖须虚需徐许序叙畜绪续酗蓄宣悬旋玄选穴学雪血勋寻巡询循训讯迅葸舄禊
ya: 压押鸦鸭牙芽崖哑亚讶咽烟淹延严言岩沿炎研盐颜檐衍掩眼演厌宴艳验焰雁燕央殃秧扬羊阳杨洋仰养氧痒样腰邀摇遥咬药要耀爷也冶野业叶页夜液一伊衣医依仪夷宜姨移遗疑乙已以矣蚁倚椅义亿忆艺议亦异役抑译易疫益谊意溢毅翼因阴音姻银引饮隐印应英婴樱鹰迎盈营蝇赢影映硬哟拥佣永咏泳勇用优忧幽悠尤由邮犹油游友有又右幼诱于予余鱼娱渔愉愚与宇羽雨语玉育郁狱浴预域欲遇御裕愈誉冤元员园原圆援缘源远怨院愿曰约月悦阅跃越云匀允运孕蚜睚痖
za: 杂灾栽宰载再在咱攒暂赞赃脏葬遭糟早枣澡藻灶皂造噪燥躁则择泽责贼怎增赠渣扎轧眨炸摘宅窄债沾粘展占战站张章涨掌丈仗帐胀障招找召兆赵照遮折哲者这浙珍真诊阵振镇震争征挣睁蒸整正证郑政症之支汁芝枝知肢织脂蜘执直值职植殖止只旨址纸指趾至志制帜治质秩致智置中忠终钟肿种仲众重州舟周洲粥轴宙昼皱骤朱珠株诸猪蛛竹烛逐主属煮嘱住助注贮驻柱祝著筑抓爪拽专砖转赚庄装壮状撞追准捉桌着仔兹姿资滋籽子紫字自宗综棕踪总纵走奏租足族阻组祖钻嘴最罪醉尊遵昨左作坐座做匝拶咂

# 补充汉字以满足3700个
beng: 崩绷泵蹦迸甭嘣
bian: 编鞭边扁便变辨辩辫卞弁苄匾汴蝙砭碥窆褊鳊
biao: 表彪膘标镖飙飚骠镖镳裱婊杓飑
bie: 别憋瘪鳖蹩
bin: 宾滨彬斌濒殡鬓摈傧玢膑髌
bing: 冰兵丙柄饼并病秉炳禀邴
bo: 波玻剥脖菠伯驳泊博搏膊薄卜播拨钵铂帛舶渤跛礴擘檗钹鹁
bu: 不布步怖部补捕哺卜簿卟钚瓿
cang: 仓苍舱藏沧伧
cao: 操糙槽草曹嘈漕艚螬
ce: 册侧厕测策岑涔
ceng: 层曾蹭噌
cha: 查察茬茶搽差叉插岔诧刹喳嚓姹杈汊碴槎锸镲
chai: 拆柴豺侪钗瘥虿
chan: 搀掺馋缠蝉产铲阐颤禅谄蟾婵忏潺羼廛澶骣躔
chang: 昌长肠尝常偿厂场敞畅倡唱怅娼猖嫦徜昶氅鲳
chao: 抄钞超巢朝嘲潮吵炒绰剿晁焯耖
chen: 尘臣沉辰陈晨趁称衬琛嗔宸谌碜龀榇
cheng: 撑成呈诚承城乘惩程澄橙逞秤称丞埕枨柽瞠铖裎蛏
chi: 吃痴持池迟驰耻齿斥赤翅尺侈哧嗤啻弛墀茌豉敕饬鸱瘛褫蚩媸笞魑
chong: 充冲虫崇宠重忡憧舂艟
chou: 抽仇绸愁稠筹酬丑臭惆踌畴雠帱
chu: 出初除厨锄础储楚处触畜矗搐躇刍怵憷杵楮樗绌蜍蹰黜
chua: 欻
chuai: 揣搋啜膪踹
chuan: 川穿传船喘串舛遄氚钏
chuang: 疮窗床创闯幢怆
chui: 吹炊垂锤捶陲棰槌
chun: 春纯唇淳醇蠢莼椿鹑蝽
chuo: 绰戳辍啜龊踔
ci: 词祠慈辞磁雌此次刺赐差疵茨瓷呲鹚糍
cong: 匆葱聪从丛囱淙骢琮璁枞
cou: 凑楱辏腠
cu: 粗促醋簇猝蹙蹴殂徂
cuan: 窜篡攒汆撺爨镩
cui: 催摧脆粹翠淬萃啐悴璀榱毳
cun: 村存寸忖皴
cuo: 搓措错挫磋蹉嵯脞矬痤鹾
da: 搭达答打大耷哒嗒鞑
dai: 呆歹代带待怠贷袋逮戴傣岱殆呔玳迨骀绐埭
dan: 丹单担耽胆旦但诞弹淡蛋耽郸掸惮啖澹殚赕眈瘅箪
dang: 当挡党荡档铛裆凼砀宕
de: 得德的锝
deng: 灯登等瞪凳蹬噔磴戥镫簦
di: 低堤滴迪敌笛底抵地弟帝递第的迪涤嘀嫡诋邸坻荻谛娣柢棣觌骶
dian: 颠典点电佃店垫淀殿滇奠甸惦掂癜碘簟踮阽坫靛
die: 跌叠蝶迭谍碟喋佚垤堞揲牒瓞耋蹀鲽
ding: 丁叮盯钉顶订定鼎仃啶玎腚碇町铤疔耵
diu: 丢铥
dong: 东冬董懂动冻栋洞咚岽峒氡胨胴鸫
dou: 兜抖斗陡豆逗痘蔸窦蚪篼
du: 都督毒读独堵赌杜肚度渡妒嘟渎牍犊黩髑椟芏蠹
duan: 端短段断缎煅锻簖
dui: 堆队对兑怼憝碓
dun: 吨敦蹲盾顿钝沌炖遁盹趸
duo: 多夺朵躲舵堕惰咄哆踱垛驮掇铎裰哚缍
en: 恩蒽摁
er: 而尔耳二贰佴迩珥铒鸸鲕
fa: 发乏伐罚阀筏砝
fan: 翻凡烦繁反返犯饭泛范贩藩帆矾梵幡蕃燔畈蹯
fang: 方坊芳防妨房仿访纺放坊邡枋钫鲂
fei: 飞非啡肥匪诽吠肺废沸费菲妃绯扉霏腓斐悱狒榧淝痱蜚篚翡
fen: 分芬吩纷氛坟焚粉份奋愤粪芬汾棼瀵鲼鼢
feng: 丰风封疯峰锋蜂逢缝讽凤奉枫烽俸酆葑唪沣砜
fo: 佛
fou: 否缶
fu: 夫敷肤伏扶拂服俘浮符幅福抚甫府斧俯辅腐父付负妇附咐复赴副傅富腹覆凫芙孚驸绂桴赙麸稃匐罘涪黻黼鳆
ga: 该改盖概钙丐尬陔垓戤赅
gai: 改盖概钙溉丐陔戤赅
gan: 干甘杆肝竿秆赶敢感干赣坩苷尴擀泔淦澉绀橄旰矸疳酐
gang: 冈刚纲缸钢岗港杠罡戆筻
gao: 高膏篙糕搞稿告睾槔杲缟槁藁镐
ge: 哥歌搁割革葛格隔个各戈疙咯胳鸽搁鬲仡哿圪塥嗝纥膈硌镉袼舸
gei: 给
gen: 根跟亘艮茛
geng: 更耕工弓公功攻供宫恭躬巩拱共庚羹埂哽绠赓鲠
gong: 工弓公功攻供宫恭躬巩拱共汞肱觥蚣
gou: 勾沟钩狗构购够苟垢佝诟媾岣遘枸篝鞲
gu: 姑古谷股骨鼓固故顾雇辜咕沽菇箍蛊鹄汩诂牯瞽毂罟钴鸪鹘痼蛄酤觚鲴
gua: 瓜刮挂寡卦呱剐胍诖栝鸹
guai: 乖拐怪
guan: 关观官冠棺馆管贯惯灌罐纶倌莞掼涫盥鹳鳏
guang: 光广逛咣犷桄胱
gui: 归龟规闺轨鬼柜贵桂跪瑰诡癸圭硅皈傀妫庋宄晷炅簋鲑鳜
gun: 滚棍衮绲磙辊
guo: 国果过郭锅裹涡帼呙埚掴猓崞聒馘
hai: 孩海害氦亥骇骸嗨胲醢
han: 含函寒喊罕汉汗旱悍焊憾撼翰瀚酣憨邯韩邗菡撖阚晗焓顸
hang: 行航巷吭杭沆绗珩桁
hao: 毫豪好号浩耗嚎壕郝皓蒿濠嗥薅嚆蚝
he: 喝合何和河核荷盒贺禾呵赫褐鹤壑阂涸劾嗬阖曷盍颌蚵翮
hei: 黑嘿
hen: 痕很狠恨
heng: 哼恒横衡亨桁蘅
hong: 红宏洪虹鸿轰哄烘弘泓闳讧荭蕻薨
hou: 侯喉猴吼后厚候逅糇骺鲎篌
hu: 乎呼忽狐胡壶湖糊虎互户护弧瑚蝴唬葫沪冱唿囫岵猢怙惚浒滹琥槲轷觳烀煳戽扈鹕笏醐斛
hua: 花华哗滑猾化划画话华砉桦骅
huai: 怀槐坏徊淮踝
huan: 欢还环缓幻唤换患焕疾豢桓寰奂洹浣漶萑圜郇缳锾鲩鬟
huang: 慌皇黄煌晃谎荒惶簧凰恍徨湟潢璜肓癀蟥篁鳇
hui: 灰挥恢辉回毁悔汇会讳绘贿秽惠慧晦徽卉麾诙隳咴哕洄彗缋珲蕙喙恚虺蟪
hun: 昏婚浑魂混馄阍溷
huo: 活火伙或货获祸惑豁霍藿嚯夥劐攉钬锪镬耠蠖
ji: 击饥圾机肌鸡迹积基绩激及吉级即极急疾集籍几己挤脊计记纪忌技际剂季既济继寄寂丌乩剞掎彐麂
jia: 家加夹佳嘉甲钾价驾架假嫁稼伽迦珈枷痂笳袈跏郏葭岬浃胛铗镓瘕
jian: 间肩艰兼监煎拣俭柬捡检减剪简见件建剑荐贱健舰渐溅鉴键箭奸尖坚歼监笺缄谫戋囝犍湔蹇謇枧楗戬牮犍毽腱睑锏鹣裥笕翦趼踺鲣鞯
jiang: 将姜浆僵疆讲奖匠降酱江豇茳洚绛缰犟礓耩糨
jiao: 交郊浇骄娇胶教焦嚼角狡脚搅缴叫轿较蕉椒礁礁侥佼僬艽茭挢敫徼湫姣皎鹪蛟跤鲛
jin: 今金津筋仅紧锦谨尽劲近进晋浸禁襟巾斤矜卺荩堇噤馑廑妗缙瑾槿赆觐钅衿
jing: 京经茎惊晶睛精井颈景警净径竞竟敬境静靖竟菁阱儆阱泾肼胫腈旌婧晟箐獍
jiong: 窘迥炯扃
jiu: 九久酒旧救就舅揪疚咎厩啾阄柩桕鸠鹫赳鬏
ju: 居拘鞠局菊橘举矩句巨拒具剧惧据距锯聚驹疽踞倨讵苴苣莒掬遽琚椐榘榉橘犋飓钜锔窭裾趄醵
juan: 捐卷倦绢娟隽涓镌鄄狷桊蠲
jue: 觉掘嚼决绝爵诀厥劂蕨噘撅獗珏桷橛爝矍镢
jun: 军君均菌俊峻骏钧郡竣捃皲筠麇
ka: 卡咖喀咔佧胩
kai: 开揩凯慨楷恺铠锴蒈
kan: 看刊堪砍坎侃勘瞰龛戡莰
kang: 康慷糠扛抗炕亢伉闶钪
kao: 考烤靠拷栲犒铐
ke: 科棵颗壳咳可渴克刻客课坷苛柯呵珂轲氪颏瞌稞疴窠钶锞骒缂
ken: 肯垦恳啃龈裉
keng: 坑吭铿
kong: 空孔恐控崆箜
kou: 口扣抠寇蔻叩眍筘
ku: 哭苦库裤酷窟骷刳堀绔
kua: 夸跨挎胯侉
kuai: 块快筷侩蒯郐哙狯脍
kuan: 宽款髋
kuang: 矿框旷况匡筐狂诓邝圹夼哐纩贶
kui: 亏窥葵魁傀馈溃匮睽逵馗喟悝愦揆暌聩蒉喹篑岿隗
kun: 昆困捆坤悃阃琨锟醌鲲髡
kuo: 括阔扩廓蛞
la: 拉啦喇腊蜡辣垃剌邋旯
lai: 来莱赖睐徕涞赉崃濑癞籁
lan: 蓝栏拦篮览懒烂滥兰澜揽缆岚婪阑斓褴罱漤榄
lang: 郎狼廊朗浪榔螂啷阆蒗稂
lao: 劳牢老佬姥涝酪烙捞唠崂栳铑痨耢
le: 乐勒了叻泐鳓
lei: 类累雷垒泪镭蕾磊儡擂肋羸诔嘞嫘缧檑耒酹
leng: 冷棱楞愣塄
li: 里理鲤力历厉立丽利励例隶俩黎篱离璃梨犁厘礼李莉荔吏栗砾漓俐狸莉痢鲤砾笠篱俪喱郦坜苈莅蓠藜呖唳猁溧澧逦娌嫠骊缡枥栎轹戾砺詈罹锂鹂疠疬蛎蜊蠡篥粝醴
lian: 连帘怜莲联廉脸练炼恋链涟敛琏殓蔹奁潋濂裢裣蠊鲢
liang: 两亮谅辆量粮凉梁良粱墚椋踉靓魉
liao: 了料聊僚疗辽撩寥潦燎缭撂尥嘹獠寮缭钌鹩
lie: 列劣烈猎裂冽洌趔躐鬣
lin: 林临淋磷邻赁吝拎琳霖鳞凛蔺啉嶙廪懔遴檩辚膦瞵粼
ling: 令灵铃陵零龄领岭另棱伶玲凌铃羚翎苓聆囹泠棂瓴绫柃蛉酃鲮
liu: 六刘留流硫榴柳馏溜瘤琉遛浏骝绺旒熘锍镏鹨
long: 龙聋隆垄拢笼弄咙窿陇珑胧栊泷癃砻
lou: 楼搂漏露娄篓偻蒌喽嵝镂瘘耧蝼髅
lu: 路露录鹿碌陆驴旅屡律虑滤卢芦炉鲁卤虏掳戮潞禄麓辘渌逯璐栌橹轳辂辘氇胪镥鸬鹭
lv: 绿滤吕铝侣旅屡缕履律虑氯率驴偻捋闾榈膂稆褛
luan: 乱卵峦挛孪滦脔娈栾鸾銮
lue: 略掠锊
lun: 论轮伦仑抡纶囵沦
luo: 落罗螺洛络逻萝锣箩骡裸骆倮蠃荦摞猡泺漯珞椤脶镙瘰雒
ma: 妈麻马玛码蚂骂吗祃犸杩
mai: 麦卖迈脉埋霾劢荬
man: 满慢曼漫瞒蔓蛮馒谩墁幔缦熳镘颟螨鳗
mang: 忙芒盲茫氓莽邙漭硭蟒
mao: 毛矛茅茂冒贸帽貌猫锚卯铆牦髦耄茆峁瑁蝥蟊旄泖昴
me: 么麽
mei: 没眉梅媒煤霉每美妹枚酶霉莓媚嵋猸浼湄楣镅鹛
men: 门闷们扪焖懑钔
meng: 萌盟猛梦蒙檬锰勐懵甍瞢虻蜢蠓艋艨
mi: 米秘觅密蜜迷眯弥谜糜靡泌宓弭谧脒芈幂蘼咪汨宓祢猕糸縻麋
mian: 面棉免眠缅勉冕娩腼湎沔渑眄
miao: 苗描瞄秒妙庙喵邈缈缪淼杪眇鹋
mie: 灭蔑篾乜咩蠛
min: 民敏悯闽皿珉泯缗玟苠岷闵
ming: 名明鸣命铭冥茗溟瞑暝螟酩
miu: 谬缪
mo: 莫墨默模膜摩抹末没磨魔摸摹漠寞陌蘑脉馍殁茉蓦谟貊嫫麽馍秣瘼耱镆貘
mou: 某谋牟眸哞缪鍪
mu: 母亩牡姆拇木目牧墓幕慕暮穆募睦仫坶苜沐毪钼
na: 那拿哪纳钠乃捺肭衲
nai: 奶耐奈氖艿萘柰鼐
nan: 南男难喃囡楠腩蝻
nang: 囊囔馕曩
nao: 脑闹恼挠淖孬垴呶猱瑙硇铙蛲
ne: 呢讷
nei: 内那馁
nen: 嫩恁
neng: 能
ni: 你泥拟逆尼妮霓倪匿溺昵腻伲坭猊怩昵旎祢慝睨铌鲵
nian: 年念捻碾撵拈蔫黏鲇鲶廿辇
niang: 娘酿
niao: 鸟尿袅茑嬲脲
nie: 捏聂孽涅镍啮乜陧蘖嗫颞臬蹑
nin: 您
ning: 宁凝拧柠狞泞佞甯咛聍
niu: 牛扭纽钮忸妞狃
nong: 农浓弄脓侬哝
nu: 奴努怒弩胬驽孥
nv: 女钕恧
nuan: 暖
nue: 虐疟谑
nuo: 挪诺糯懦喏傩搦锘
ou: 欧鸥殴偶藕呕沤耦怄瓯
pa: 怕爬趴啪耙琶葩杷筢
pai: 派排拍牌迫徘湃俳蒎哌
pan: 盘判叛盼攀畔潘磐蟠蹒拚爿泮袢襻
pang: 旁胖庞乓磅彷滂逄螃耪
pao: 跑炮抛泡刨袍咆疱狍庖脬
pei: 配陪培赔佩呸胚沛裴旆辔帔淠锫霈
pen: 喷盆湓
peng: 碰棚蓬朋捧彭烹硼澎篷膨抨砰嘭怦堋蟛
pi: 批披劈皮疲匹痞僻屁譬啤脾霹霹丕仳陂陴邳郫圮埤鼙芘擗噼庀枇甓睥罴铍癖疋蚍蜱貔
pian: 片偏篇骗便扁翩犏骈蹁胼谝
piao: 票飘漂瓢剽嫖嘌骠缥殍瞟螵
pie: 撇瞥氕苤
pin: 品贫频拼聘嫔姘牝颦
ping: 平评凭苹瓶萍屏乒坪枰娉俜鲆
po: 坡泼婆迫破魄泊颇粕叵鄱珀钋钷皤笸
pou: 剖裒掊
pu: 扑铺仆葡朴普谱瀑蒲圃埔浦曝溥匍噗蹼璞氆镤镨
qi: 七妻凄戚期欺漆齐其奇歧骑棋旗乞企岂启起气迄弃汽契砌器恰洽俟汔碛葺
qia: 卡恰掐洽葜髂
qian: 千迁牵铅谦签前钱钳潜浅遣欠款乾黔遣悭骞阡掮芊芡茜荨愆缱佥褰搴钎仟岍悭慊椠犍肷钤锓
qiang: 枪腔强墙抢呛跄羌蔷戕嫱樯戗炝锖锵镪
qiao: 桥瞧巧悄敲锹乔侨翘峭窍俏撬鞘橇憔樵诮谯荞愀憔硗鞒
qie: 切茄且窃砌妾怯惬伽挈锲箧
qin: 亲侵芹琴禽勤秦钦沁寝擒嗪芩揿吣噙廑溱檎锓衾
qing: 青氢轻倾清情晴顷请庆亲卿擎氰罄磬謦鲭黥
qiong: 穷琼穹邛茕蛩筇跫銎
qiu: 求球秋丘囚酋泅俅虬犰湫逑遒楸赇蚯蝤裘糗鳅
qu: 区曲驱屈趋渠取娶去趣蛆躯龋祛蕖蘧岖衢阒璩觑氍朐磲鸲癯
quan: 全权泉拳犬劝圈券诠荃悛绻辁畎铨蜷筌鬈
que: 却雀确鹊缺瘸炔阕阙悫
qun: 群裙逡麇
ran: 然燃染冉苒蚺髯
rang: 嚷壤让瓤攘禳穰
rao: 绕扰饶娆桡荛
re: 热惹
ren: 人仁忍认任刃壬韧妊纫仞荏葚饪轫稔衽
reng: 扔仍
ri: 日
rong: 容熔融绒荣蓉溶茸戎冗嵘狨榕肜蝾
rou: 肉柔揉蹂鞣糅
ru: 如儒乳辱入汝褥蠕嚅茹濡孺洳溽缛铷襦颥
ruan: 软阮朊
rui: 瑞锐芮蕊蚋睿蕤枘
run: 润闰
ruo: 若弱偌箬
sa: 撒洒萨卅挲脎
sai: 塞赛腮鳃噻
san: 三散伞叁毵馓糁
sang: 桑嗓丧搡磉颡
sao: 扫嫂骚搔瘙缫臊鳋
se: 色涩瑟啬铯穑
sen: 森
seng: 僧
sha: 沙纱傻啥杀刹砂莎煞霎裟痧鲨唼歃
shai: 晒筛酾
shan: 山删衫闪陕扇善赡杉擅膳栅汕珊煽姗跚膻讪鄯埏芟潸缮嬗骟鳝
shang: 上伤尚商赏裳晌垧绱殇觞
shao: 少烧稍勺哨梢捎绍韶芍邵劭杓筲艄
she: 社设射摄蛇舌舍涉赊赦慑奢厍猞滠佘畲麝
shen: 身深神审婶肾甚渗申伸慎沈绅呻砷娠莘哂矧椹胂渖诜谂
sheng: 生声性牲胜绳省圣盛剩升甥笙渑晟眚
shi: 是时十使事实式识世试石什示市史师始施士势适视食室氏蚀诗湿失狮尸拾逝誓侍释嗜蚀嘘螫匙埘莳蓍弑轼贳炻铈舐筮豕鲥鲺
shou: 手守首寿受兽售授瘦收熟狩绶艏
shu: 书叔殊梳疏舒输蔬熟暑属鼠数术束述树竖恕墅枢淑抒曙蜀黍塾倏殳纾沭毹腧菽秫
shua: 刷耍唰
shuai: 摔甩衰帅蟀
shuan: 栓拴闩涮
shuang: 双霜爽泷孀
shui: 水谁睡税
shun: 顺吮瞬舜
shuo: 说数朔硕烁铄妁蒴槊搠
si: 思斯丝私司死似饲四寺肆厮俟兕厶咝汜泗澌姒驷缌祀锶鸶耜蛳
song: 松宋送诵颂讼耸怂悚忪淞菘崧嵩竦
sou: 搜艘嗽擞叟薮嗖馊溲飕瞍锼螋
su: 苏俗诉肃素速宿塑酥溯粟夙谡蔌嗉愫涑簌觫
suan: 算酸蒜狻
sui: 随岁碎穗虽尿髓遂隧祟绥隋睢濉燧眭
sun: 孙损笋荪狲飧榫隼
suo: 所缩锁索唆梭琐莎唢嗦娑桫睃羧
ta: 他它她塌塔踏溻獭鳎
tai: 太态泰台抬胎汰苔跆邰薹肽酞钛鲐
tan: 谈叹炭探贪摊滩坛痰潭坦瘫谭檀昙忐钽澹郯锬覃
tang: 堂塘膛糖倘躺趟汤唐棠淌烫傥帑溏瑭樘螗羰醣镗
tao: 讨套逃桃陶淘涛滔掏萄绦鼗啕洮韬焘饕
te: 特忑忒铽
teng: 藤腾疼誊滕
ti: 体替梯踢啼提题蹄剔涕惕屉倜悌逖缇鹈锑荑
tian: 天添田甜填恬舔佃忝殄畋阗
tiao: 条跳挑调眺迢佻苕窕髫笤龆鲦
tie: 铁贴帖萜餮
ting: 厅听烃廷亭庭停挺艇汀莛葶婷梃铤蜓霆
tong: 同铜童统痛通桶筒彤佟恸仝茼峒潼砼
tou: 偷头投透骰
tu: 土吐兔图徒途涂屠凸秃荼钍菟酴
tuan: 团湍抟彖疃
tui: 推腿退颓蜕煺
tun: 吞屯褪臀囤豚饨
tuo: 拖脱托驼妥拓唾驮沱佗坨庹柝橐砣箨鸵鼍
wa: 挖哇蛙娃瓦洼娲畖
wai: 外歪崴
wan: 万完玩顽挽晚碗弯湾丸豌婉腕宛惋蜿烷芄莞菀纨绾琬脘畹
wang: 往忘望王网亡旺妄惘罔尢辋魍
wei: 为位未委维卫伟围威微危唯谓喂慰魏伪畏胃韦违苇萎纬惟蔚尉潍渭偎薇猥炜逶娓玮痿猬煨圩隗洧涠逶帏帷崴嵬猥韪炜煨艉鲔
wen: 文问闻温稳吻蚊纹瘟汶雯阌璺
weng: 翁嗡瓮蓊蕹
wo: 我握窝卧沃涡斡蜗倭喔幄渥肟硪龌
wu: 无五物务武午舞伍误恶屋乌污吴吾悟雾毋梧巫诬呜芜坞戊晤捂兀仵阢邬圬芴庑怃杌焐鹜痦蜈鋈鼯
xi: 西息希习细系吸喜席析洗稀戏溪袭悉锡夕牺膝昔熙隙郗茜熹皙蜥奚唏铣饩阋玺樨浠淅嬉羲矽禧曦觋蟋舾粞禊
xia: 下夏吓虾瞎霞狭峡匣辖暇侠厦呷狎遐瑕柙硖瘕罅黠
xian: 现线先县显限闲险鲜献掀纤仙贤衔咸馅陷腺涎舷羡冼苋莶藓岘猃暹娴氙燹祆籼痃蚬跹酰霰
xiang: 想向相象像香乡响项箱详享降巷祥橡厢湘镶翔襄飨饷骧庠芗葙蟓鲞
xiao: 小笑校消效晓销削萧硝霄啸嚣哮骁枭哓潇逍绡枭箫筱魈
xie: 些写谢协械解鞋血斜携胁泄屑邪挟谐卸泻懈蟹蝎楔泄邂瀣勰燮躞绁颉缬榭榍
xin: 新心信欣辛薪芯锌衅忻莘鑫歆囟馨
xing: 行性形型星兴醒姓幸腥猩邢陉荇荥擤悻硎
xiong: 雄胸凶兄熊汹芎
xiu: 修休秀袖朽臭羞绣锈嗅咻貅馐髹鸺
xu: 需许续须虚序徐畜蓄叙绪吁戌墟栩恤酗胥糈婿诩勖盱蓿洫溆顼
xuan: 选宣旋悬玄券轩喧绚眩萱渲暄璇铉儇煊碹揎镟
xue: 学血雪削穴靴谑泶鳕
xun: 训讯迅寻循巡询逊熏旬勋驯汛徇殉巽埙荀蕈薰峋窨獯恂洵浔曛醺鲟
ya: 压押鸦鸭牙芽崖哑亚讶蚜睚痖
yan: 眼言严验研烟演延沿炎盐颜岩掩艳厌燕咽宴淹雁焰焉嫣檐堰奄俨偃腌阉晏胭妍焱筵滟魇闫郾琰恹闫湮酽鄢赝菸崦阏兖餍鼹
yang: 样养氧扬羊阳杨洋仰秧殃央鸯漾徉炀烊恙鞅蛘
yao: 要药摇腰咬邀耀遥谣窑姚妖瑶尧钥侥吆夭爻肴杳鹞舀窈繇鳐
ye: 也业夜叶野页液冶爷咽椰噎烨掖曳邺谒揶晔腋靥
yi: 一以义意已议衣医依易艺益移异遗疑仪宜亿椅伊忆役谊译抑翼矣逸肆邑夷怡绎胰姨沂彝咦屹弈奕羿轶贻懿诣迤翌熠刈劓佚佾诒圯埸懿苡荑薏弋呓嗌噫峄嶷猗饴怿怡挹旖殪轶漪熠眙钇镒镱痍瘗癔翊蜴舣羿翳酏
yin: 因音引印阴银隐饮姻吟淫茵荫寅殷胤鄞垠喑堙狺夤洇氤铟瘾茚龈霪蚓
ying: 应影英营迎硬映赢盈颖鹰婴樱缨荧莹萤蝇萦莺楹瀛嬴郢蓥颍璎嘤撄瑛滢潆嬴瘿罂
yo: 哟唷
yong: 用勇永拥涌泳佣庸咏踊痈雍臃慵俑墉镛邕喁饔鳙
you: 有由又右友油游优忧尤邮犹幽悠佑诱釉攸酉莠呦囿牖柚铀猷疣蚰蝣鱿黝鼬
yu: 于与育语预遇域余鱼雨玉愈欲渔予羽愉誉愚裕郁寓狱浴御宇吁舆屿淤禹芋喻峪毓隅迂渝瑜虞榆俞逾舆昱萸腴阈窬禺妤伛俣谀谕庾阈鬻妪纡馀觎欤煜熨嵛瘀雩鹆鹬竽舁
yuan: 元原员远愿园源圆院怨缘援冤袁渊苑猿鸳辕垣沅媛橼爰眢鸢螈箢鼋
yue: 月说越约乐跃阅岳悦曰粤钥刖龠樾瀹
yun: 运云匀允孕晕韵酝蕴耘郧芸纭昀殒愠氲熨
za: 杂砸咋匝咂
zai: 在再载灾栽宰哉崽甾
zan: 咱暂攒赞簪糌瓒昝趱錾
zang: 藏脏葬赃奘驵
zao: 早造遭糟澡灶燥躁凿枣皂藻噪蚤唣
ze: 则择责泽仄啧迮昃笮箦舴
zei: 贼
zen: 怎谮
zeng: 增曾赠憎锃甑缯罾
zha: 扎炸渣闸眨榨乍轧诈札栅咋喳揸吒哳咤砟痄蚱齄
zhai: 债摘窄斋寨宅翟砦瘵
zhan: 战站展占沾粘斩辗崭瞻毡绽栈湛詹谵搌旃
zhang: 张章长掌涨丈仗帐胀障彰璋蟑樟仉鄣瘴嶂獐
zhao: 找照招朝召爪罩兆昭沼肇钊诏啁棹笊
zhe: 这着者折哲浙遮辙蔗锗褶蜇谪柘辄鹧磔
zhen: 真针阵镇震振珍诊贞侦枕斟圳臻甄砧疹朕桢轸榛赈鸩胗浈溱蓁椹稹箴
zheng: 正政争整证征症郑挣睁征铮蒸拯峥徵诤峥钲
zhi: 之支只制知直指治质职值执止置纸志至识致织殖植智殖枝肢脂汁芝蜘旨趾址帜峙稚挚掷秩窒炙痔滞咫芷陟郅桎轾忮贽膣祉祗枳鸷蛭絷踬胝觯
zhong: 中种重众终钟忠肿仲衷冢锺螽舯
zhou: 周州洲粥轴舟皱骤宙咒昼肘帚纣诌绉胄荮碡籀酎
zhu: 主住注助著逐竹筑珠株柱诸猪蛛朱煮烛嘱瞩贮铸驻蛀拄诛渚躅杼翥茱洙侏瘃槠铢舳箸
zhua: 抓爪
zhuai: 拽
zhuan: 转专传赚砖撰篆啭馔颛
zhuang: 装状壮庄撞桩妆幢僮
zhui: 追锥坠缀赘椎惴骓缒
zhun: 准谆肫窀
zhuo: 着桌捉卓琢灼酌拙浊啄茁倬诼擢浞涿濯禚斫镯
zi: 子自资字紫仔兹姿滋籽咨孜渍吱姊孳淄笫粢谘嵫缁辎梓赀眦呲锱秭耔
zong: 总宗纵踪棕综鬃偬枞腙粽
zou: 走奏邹揍诹陬鄹驺鲰
zu: 组族足租阻祖诅俎菹镞
zuan: 钻攥纂缵躜
zui: 最罪嘴醉咀蕞
zun: 尊遵樽鳟撙
zuo: 作做坐座左昨琢佐凿撮唑嘬怍柞胙祚砟
qi: 一乙二十丁厂七卜八人入儿九匕几刁了乃刀力又乜三干亍于亏士土工才下寸丈大兀与万弋上小口山巾千乞川亿彳
dd: 个么久勺丸夕凡及广亡门丫义之尸已巳弓己卫孑子孓也女飞刃习叉马乡幺丰王井开亓夫天元无韦云专丐扎廿艺木五支
aa: 厅卅不仄太犬区历友歹尤匹厄车巨牙屯戈比互切瓦止少曰日中贝内水冈见手午牛毛气壬升夭长仁仃什片仆仉化仇币仂仍仅斤
bb:爪反兮刈介父爻从仑今凶分乏公仓月氏勿风欠丹匀乌勾殳凤卞六文亢方闩火为斗忆计订户讣认讥冗心尹尺夬引丑爿巴孔队办以允邓
cc:予劝双书毋幻玉刊末未示击邗戋打巧正扑卉扒邛功扔去甘世艾艽古节艿本术札可叵匝丙左厉丕石右布夯龙戊平灭轧东匜劢卡北占凸卢
dd:业旧帅归目旦且叮叶甲申号电田由卟叭只央史叱叽兄叼叩叫叻叨另叹冉皿凹囚四生失矢氕乍禾仨仕丘付仗代仙仟仡仫伋们仪白仔他仞斥
qq:卮瓜乎丛令用甩印氐乐尔句匆犰册卯犯外处冬鸟务刍包饥主市庀邝立冯邙玄闪兰半汀汁汇头汈汉忉宁穴宄它讦讧讨写让礼讪讫训必议讯记永
vv:司尻尼民弗弘阢出阡辽奶奴尕加召皮边孕发圣对弁台矛纠驭母幼丝匡耒邦玎玑式迂刑邢戎动圩圬圭扛寺吉扣扦圪考托圳老圾巩执扩圹扪扫圯圮地扬场耳芋芏共芊芍
nn:芨芄芒亚芝芎芑芗朽朴机权过亘臣吏再协西压厌厍戌在百有存而页匠夸夺夼灰达戍尥列死成夹夷轨邪尧划迈
kk:毕至此乩贞师尘尖劣光当吁早吐吓旯曳虫曲团同吕吊吃因吸吗吆屿屹岌帆岁回岂屺则刚网肉凼囝囡钆钇年朱缶氘氖牝先丢廷舌竹迁乔迄伟传乒乓休伍伎伏伛优臼伢伐仳
ff:延佤仲仵件任伤伥价伦份伧华仰伉仿伙伪伫自伊血向囟似后行甪舟全会杀合兆企汆氽众爷伞创刖肌肋朵杂夙危旬旭旮旨负犴刎犷匈犸舛各名多凫争邬色饧冱壮冲妆冰庄庆亦刘齐交次衣产决亥邡充妄闭问闯羊并关米灯州汗污江汕汔汲
xc:汐汛汜池汝汤汊忖忏忙兴宇守宅字安讲讳讴军讵讶祁讷许讹论讼农讽设访诀聿寻那艮厾迅尽导异弛阱阮孙阵阳收阪阶阴防丞奸如妁妇妃好她妈戏羽观牟欢买纡红纣驮纤纥驯纨约级纩纪驰纫巡寿玕弄玙麦玖玚玛形进戒吞远违韧运扶抚坛
gh:抟技坏抔抠坜扰扼拒找批扯址走抄汞坝贡攻赤圻折抓扳坂抡扮抢扺孝坎坍均坞抑抛投抃坟坑抗坊抖护壳志块抉扭声把报拟抒却劫毐芙芫芜苇邯芸芾芰苈苊苣芽芷芮苋芼苌花芹芥苁芩芬苍芪
pp:芴芡芟苄芳严苎芦芯劳克芭苏苡杆杜杠材村杖杌杏杉巫杓极杧杞李杨杈求忑孛甫匣更束吾豆两邴酉丽医辰励邳否还矶奁豕尬歼来忒连欤轩轪轫迓邶忐芈步卤卣邺坚肖旰旱盯呈时吴呋助县里呓呆吱吠呔呕园呖呃旷围呀吨旸吡
jk:町足虬邮男困吵串呙呐呗员听吟吩呛吻吹呜吭吣吲吼邑吧囤别吮岍帏岐岖岈岗岘帐岑岚兕财囵囫钉针钊钋钌迕氙氚牡告我乱利秃秀私岙每佞兵邱估体何佐伾佑攸但伸佃佚作伯伶佣低你佝佟住位伴佗身皂伺佛伽囱近彻役彷返佘余希佥坐谷
sg:孚妥豸含邻坌岔肝肟肛肚肘肠邸龟甸奂免劬狂犹狈狄角删狃狁鸠条彤卵灸岛邹刨饨迎饩饪饫饬饭饮系言冻状亩况亨庑床庋库庇疔疖疗吝应冷这庐序辛肓弃冶忘闰闱闲闳间闵闶闷羌判兑灶灿灼炀弟沣汪沅沄沐沛沔汰沤
lo:沥沌沘沏沚沙汩汨汭汽沃沂沦汹汾泛沧沨沟没汴汶沆沩沪沈沉沁泐怃忮怀怄忧忡忤忾怅忻忪怆忭忱快忸完宋宏牢究穷灾良证诂诃启评补初社祀祃诅识诈诉罕诊诋诌词诎诏诐译
cj:诒君灵即层屁屃尿尾迟局改张忌际陆阿孜陇陈阽阻阼附坠陀陂陉妍妩妓妪妣妙妊妖妗姊妨妫妒妞姒妤努邵劭忍刭劲甬邰矣鸡纬纭驱纯纰纱纲纳纴纵驳纶纷纸纹纺纻驴纽纾奉玩玮环玡武青责现玫玠玢玥表玦甙盂忝
op:规匦抹卦邽坩坷坯拓垅拢拔抨坪拣拤拈坫垆坦担坤押抻抽拐拃拖拊者拍顶坼
en:拆拎拥抵坻拘势抱拄垃拉拦幸拌拧坨坭抿拂拙招坡披拨择拚抬拇坳拗耵其耶取茉苷苦苯昔苛苤若茂茏苹苫苴苜苗英苒苘茌苻苓茚苟茆茑苑苞范茓
lr:茔茕直苠茀茁茄苕茎苔茅枉林枝杯枢枥柜枇杪杳枘枧杵枚枨析板枞松枪枫构杭枋杰述枕杻杷杼丧或画卧事刺枣雨卖矸郁矻矾矽矿砀码厕奈刳奔奇奄奋态瓯欧殴垄殁
kr:郏妻轰顷转轭斩轮软到郅鸢非叔歧肯齿些卓虎虏肾贤尚盱旺具昊昙果味杲昃昆国哎咕昌呵咂畅呸昕明易咙昀昂旻昉炅咔畀虮迪典固忠咀呷呻黾咒咋咐呱呼呤咚
pd:鸣咆咛咏呢咄呶咖呦咝岵岢岸岩帖罗岿岬岫帜帙帕岭岣峁刿峂迥岷剀凯帔峄沓败账贩贬购贮囹图罔钍钎钏钐钓钒钔钕钗邾制知迭氛迮垂牦牧物乖刮秆和季委
hf:竺秉迤佳侍佶岳佬佴供使侑佰侉例侠臾侥版侄岱侦侣侗侃侧侏凭侨侩佻佾佩货侈侪佼依佯侬帛卑的迫阜侔质欣郈征徂往爬彼径所舍金刽郐刹命肴郄斧怂爸采籴觅受乳
hl:贪念贫忿瓮戗肼肤朊肺肢肽肱肫肿肭胀朋肷股肮肪肥服胁周剁昏迩郇鱼兔狉狙狎狐忽弥狗狍狞狒咎备炙枭饯饰饱饲饳饴冽变京享冼庞店夜庙府底庖疟疠疝疙疚疡剂卒郊兖庚废净妾盲放刻於劾育氓闸闹郑券卷单炜炬炖炒炝炊炕炎炉炔沫浅法泚浈浉浊洞洇洄测洙洗活洑涎洎洫派浍洽洮染洵洚洺洛浏济洨浐洋洴洣洲浑浒浓津浔浕洳恸恃恒恹恢恍恫恺恻恬恤恰恂恪恼恽恨举觉宣宦宥宬室宫宪突穿窀窃客诫冠诬语扁扃袆衲衽袄衿袂祛祜祓祖神祝祚诮祗祢祠误诰诱诲诳鸩说昶诵建肃隶录帚屉居届刷鸤屈弧弥弦承孟陋戕陌
mb:孤孢陕亟降函陔限卺妹姑姐妲妯姓姗妮始帑弩孥驽姆虱迦迢驾叁参迨艰线绀绁绂练驵组绅细驶织驷驸驹终绉驺驻绊驼绋绌绍驿绎经骀贯甾彗耜焘舂琎球琏琐理琇麸琉琅捧掭堵揶措描埴域捺掎埼掩埯捷捯排焉掉掳掴埸堌捶赦赧推堆捭埠晳掀逵授捻埝堋教堍掏掐掬鸷掠掂掖培掊接堉掷掸控捩掮探悫埭埽据掘掺掇掼职聃基聆勘聊聍娶菁
nm:菝著菱萁菥菘堇勒黄萘萋勚菲菽菖萌萜萝菌萎萸萑菂菜棻菔菟萄萏菊萃菩菼菏萍菹菠菪菅菀萤营萦乾萧菰菡萨菇械梽彬梵梦婪梗梧梾梢梏梅觋检桴桷梓梳棁梯桫棂桶梭救啬郾匮曹敕副豉票鄄酝酞酗酚厢厣戚戛硎硅硭硒硕硖硗硐硚硇硌鸸瓠匏奢盔爽厩聋龚殒殓殍盛赉匾雩雪辄辅辆堑龁颅虚彪雀堂常眶眭唪眦啧匙晡晤晨眺眵睁眯眼眸悬野圊啪啦喏喵啉勖曼晦晞晗晚冕啄啭啡畦趼趺距趾啃跃啮跄略蚶蛄蛎蛆蚰蚺蛊圉蚱蚯蛉蛀蛇蛏蚴唬累
kn:鄂唱患啰唾唯啤啥啁啕唿啐唼唷啴啖啵啶啷唳啸啜帻崖崎崦崭逻帼崮崔帷崟崤崩崞崇崆崛赇赈婴赊圈铐铑铒铕铗铘铙铚铛铜铝铞铟铠铡铢铣铤铥铧铨铩铪铫铭铬铮铯铰铱铲铳铴铵银铷矫氪牾甜鸹秸梨犁稆秽移秾逶笺筇笨笸笼笪笛笙笮符笱笠笥第笳笤笾笞敏偾做鸺偃偕袋悠偿偶偈偎偲傀偷您偬售停偻偏躯皑兜皎假衅鸻徘徙倘得衔舸舻舳盘舴舶船鸼舷舵斜龛盒鸽瓻敛悉
lm:欲彩领翎脚脖脯豚脶脸脞脬脱脘脲朘匐鱾象够逸猜猪猎猫猗凰猖猡猊猞猄猝斛觖猕猛馗祭馃馄馅馆凑减鸾毫孰烹庶庹麻庵庼庾庳痔痍疵痊痒痕廊康庸鹿盗章竟翊商旌族旎旋望袤率阇阈阉阊阋阌阍阎阏阐着羚羝羟
ap:盖眷粝粘粗粕粒断剪兽敝焐焊烯焓焕烽焖烷烺焌清渍添渚鸿淇淋淅淞渎涯淹涿渠渐淑淖挲淌淏混淠涸渑淮淦淆渊淫淝渔淘淳液淬涪淤淡淙淀涫深渌涮涵婆梁渗淄情惬悻惜惭悱悼惝惧惕惘悸惟惆惚惊惇惦悴惮惋惨惯寇寅寄寂逭宿窒窑窕密谋谌谍谎谏扈皲谐谑裆袱袼裈裉祷祸祲谒谓谔谕谖谗谙谚谛谜谝逮逯敢尉屠艴弹隋堕郿随蛋隅隈粜隍隗隆隐婧婊婞婳婕娼婢婚婵婶婉胬袈颇颈翌恿欸绩绪绫骐续骑绮绯绰骒绲绳骓维绵绶绷绸绹绺绻综绽绾绿骖缀缁巢耠琫琵琴琶琪瑛琳琦琢琥琨靓琼斑琰琮琯琬琛琚辇替鼋揳揍款堪堞搽塔搭塃揸堰揠堙揩越趄趁趋超揽提堤揖博揾颉揭喜彭揣塄揿插揪搜煮堠耋揄援搀蛰蛩絷塆裁揞搁搓搂搅揎壹握摒揆搔揉掾葜聒斯期欺联葑葚葫靰靸散葳惹蒇葬蒈募葺葛蒉葸萼蓇萩董葆葩葡敬葱蒋葶蒂蒌葓蒎落萱葖韩戟朝葭辜葵棒楮棱棋椰植森棼焚椟椅椒棹棵棍椤棰椎棉椑鹀赍棚椋椁棬棕棺榔楗棣椐椭鹁惠惑逼覃粟棘酣酤酢酥酡酦鹂觌厨厦硬硝硪硷确硫雁厥殖裂雄殚殛颊雳雯辊辋椠暂辌辍辎雅翘辈斐悲紫凿黹辉敞棠牚赏掌晴睐暑最晰量睑睇鼎睃喷戢喋嗒喃喳晶喇遇喊喱喹遏晷晾景喈畴践跖跋跌跗跞跚跑跎跏跛跆遗蛙蛱蛲蛭蛳蛐蛔蛛蜓蛞蜒蛤蛴蛟蛘蛑畯喁喝鹃喂喟斝喘啾嗖喤喉喻喑啼嗟喽嗞喧喀喔喙嵌嵘嵖幅崴遄詈帽嵎崽嵚嵬嵛翙嵯嵝嵫幄嵋赋赌赎赐赑赔黑铸铹铺铻铼铽链铿销锁锃锄锂锅锆锇锈锉锊锋锌锎锏锐锑锒锓锔锕甥掣掰短智矬氰毳毯氮毽氯犊犄犋鹄犍鹅颋剩嵇稍程稀黍桴税稂筐等筘筑策筚筛筜筒筅筏筵筌答筋筝傣傲傅傈舄牍牌傥堡集焦傍傧储遑皓皖粤奥傩遁街惩御徨循舾艇舒畲弑逾颌翕釉番释鹆禽舜貂腈腊腌腓腆腴脾腋腑腙腚腔腕腱腒鱿鲀鲁鲂鲃颍猢猹猩猥猬猾猴飓觞觚猸猱惫飧然馇馈馉馊馋亵装蛮脔就敦裒庾斌痣痨痦痘痞痢痤痪痫痧痛鄌赓竦童瓿竣啻颏鹇阑阒阔阕善翔羡普粪粞尊奠遒道遂孳曾焯焜焰焙焱鹈湛港渫滞湖湘渣渤湮湎湝湨湜渺湿温渴渭溃湍溅滑湃湫溲湟溆渝湲湾渡游溠溇湔滋湉渲溉渥湄滁愤慌惰愠惺愦愕惴愣愀愎惶愧愉愔慨喾割寒富寓窜窝窖窗窘寐谟扉遍雇扊裢裎裣裕裤裥裙祾祺祼谠禅禄幂谡谢谣谤谥谦谧塈遐犀属屡孱弼强粥巽疏隔骘隙隘媒媪絮嫂媛婷媚婿巯毵翚登皴婺骛缂缃缄缅彘缆缇缈缉缌缎缏缑缒缓缔缕骗编缗骙骚缘飨耢瑟瑚鹉瑁瑞瑰瑀瑜瑗瑄瑕遨骜瑙遘韫魂髡肆摄摸填搏塥塬鄢趔趑摅塌摁鼓摆赪携塮蜇搋搬摇搞搪塘搒搐搛搠摈彀毂搌搦摊搡聘蓁戡斟蒜蓍鄞勤靴靳靶鹊蓐蓝墓幕蓦鹋蒽蓓蓖蓊蒯蓟蓬蓑蒿蒺蓠蒟蒡蓄蒹蒴蒲蒗蓉蒙蓂蓥颐蒸献蓣楔椿楠禁楂楚楝楷榄想楫榀楞楸椴槐槌楯榆榇榈槎楼榉楦概楣楹椽裘赖剽甄酮酰酯酪酩酬蜃感碛碍碘碓碑硼碉碎碚碰碇碗碌碜鹌尴雷零雾雹辏辐辑辒输督频龃龄龅龆觜訾粲虞鉴睛睹睦瞄睚嗪睫韪嗷嗉睡睨睢雎睥睬嘟嗜嗑嗫嗬嗔鄙嗦嗝愚戥嗄暖盟煦歇暗暅暄暇照遢暌畸跬跨跶跷跸跣跹跳跺跪路跻跤跟遣蛸蜈蜎蜗蛾蜊蜍蜉蜂蜣蜕畹蛹嗣嗯嗅嗥嗲嗳嗡嗌嗍嗨嗤嗵嗓署置罨罪罩蜀幌嵊嵩嵴骰锖锗错锘锚锛锜锝锞锟锡锢锣锤锥锦锧锨锪锫锩锬锭键锯锰锱矮雉氲犏辞歃稞稚稗稔稠颓愁筹筠筢筮筻筲筼筱签简筷毁舅鼠牒煲催傻像躲鹎魁敫僇衙微徭愆艄觎毹愈遥貊貅貉颔腻腠腩腰腼腽腥腮腭腹腺腧鹏塍媵腾腿詹鲅鲆鲇鲈鲉鲊稣鲋鲌鲍鲏鲐肄猿颖鹐飔飕觥触解遛煞雏馌馍馏馐酱鹑禀亶廒瘃痱痹痼廓痴痿瘐瘁瘅痰瘆廉鄘麂裔靖新鄣歆韵意旒雍阖阗阘阙羧豢誊粳粮数煎猷塑慈煤煳煜煨煅煌煊煸煺滟溱溘滠满漭漠滢滇溥溧溽源滤滥裟溻溷溦滗滫溴滏滔溪滃溜滦漓滚溏滂溢溯滨溶滓溟滘溺滍粱滩滪愫慑慎慥慊誉鲎塞骞寞窥窦窠窣窟寝谨裱褂褚裸裼裨裾裰禊福谩谪谫谬群殿辟障媾嫫媳媲嫒嫉嫌嫁嫔媸叠缙缜缚缛辔缝骝缟缠缡缢缣缤骟剿耥璈静碧瑶璃瑭瑢獒赘熬觏慝嫠韬髦墈墙摽墟墁撂摞嘉摧撄赫截翥踅誓銎摭墉境摘墒摔撇榖撖摺綦聚蔫蔷靺靼鞅靽鞁靿蔌慕暮摹蔓蔑薨蔸蓰蔹蔡蔗蔟蔺戬蔽蕖蔻蓿蔼斡熙蔚鹕兢嘏蓼榛榧模槚槛榻榫槜榭槔榴槁榜槟榨榕槠榷榍歌遭僰酵酽酾酲酷酶酴酹酿酸厮碶碡碟碴碱碣碳碲磋磁碹碥愿劂臧豨殡需霆霁辕辖辗蜚裴翡雌龇龈睿裳颗夥瞅瞍睽墅嘞嘈嗽嘌嘁嘎暧暝踌踉跽踊蜻蜞蜡蜥蜮蜾蝈蜴蝇蜘蜱蜩蜷蝉蜿螂蜢嘘嘡鹗嘣嘤嘚嘛嘀嗾嘧罴罱幔嶂幢赙罂赚骷骶鹘锲锴锶锷锸锹锻锽锾锵锿镀镁镂镃镄镅舞犒舔稳熏箐箦箧箍箸箨箕箬算箅箩箪箔管箜箢箫箓毓舆僖儆僳僚僭僬劁僦僮僧鼻魄魅魃魆睾艋鄱貌膜膊膈膀膑鲑鲔鲙鲚鲛鲜鲟疑獐獍飗觫雒孵夤馑馒銮裹敲豪膏塾遮麽廙腐瘩瘌瘗瘟瘦瘊瘥瘘瘙廖辣彰竭韶端旗旖膂阚鄯鲞精粼粹粽糁歉槊鹚弊熄熘熔煽熥潢潆潇漤漆漕漱漂滹漫漯漶潋潴漪漉漳滴漩漾演澉漏潍慢慷慵寨赛搴寡窬窨窭察蜜寤寥谭肇綮谮褡褙褐褓褛褊褪禚谯谰谱谲暨屣鹛隧嫣嫱嫩嫖嫦嫚嫘嫜嫡嫪鼐翟翠熊凳瞀鹜骠缥缦缧骡缨骢缩缪缫慧耦耧瑾璜璀璎璁璋璇璆奭撵髯髫撷撕撒撅撩趣趟撑撮撬赭播墦擒撸鋆墩撞撤撙增撺墀撰聩聪觐鞋鞑蕙鞒鞍蕈蕨蕤蕞蕺瞢蕉劐蕃蕲蕰蕊赜蔬蕴鼒槿横樯槽槭樗樘樱樊橡槲樟橄敷鹝豌飘醋醌醇醉醅靥魇餍磕磊磔磙磅碾磉殣慭震霄霉霈辘龉龊觑瞌瞒题暴瞎瞑嘻嘭噎嘶噶嘲颙暹嘹影踔踝踢踏踟踬踩踮踣踯踪踺踞蝽蝶蝾蝴蝻蝠蝰蝎蝌蝮螋蝗蝓蝣蝼蝤蝙噗嘬颚嘿噍噢噙噜噌嘱噀噔颛幞幡嶓幢嶙嶝墨骺骼骸镊镆镇镈镉镋镌镍镎镏镐镑镒镓镔靠稽稷稻黎稿稼箱箴篑篁篌篓箭篇篆僵牖儇儋躺僻德徵艘磐虢鹞鹟膝膘膛滕鲠鲡鲢鲣鲥鲤鲦鲧鲩鲪鲫鲬橥獗獠觯鹠馓馔熟摩麾褒廛瘛瘼瘪瘢瘤瘠瘫齑鹡凛颜毅羯羰糊糇遴糌糍糈糅翦遵鹣憋熜熵熠潜澍澎澌潵潮潸潭潦鲨潲鋈潟澳潘潼澈澜潽潺澄潏懂憬憔懊憧憎寮窳额谳翩褥褴褫禤谴鹤谵憨熨慰劈履屦嬉勰戮蝥豫缬缭缮缯骣畿耩耨耪璞璟靛璠璘聱螯髻髭髹擀撼擂操熹甏擐擅擞磬鄹颞蕻鞘燕黇颟薤蕾薯薨薛薇檠擎薪薏蕹薮薄颠翰噩薜薅樾橱橛橇樵檎橹橦樽樨橙橘橼墼整橐融翮瓢醛醐醍醒醚醑觱磺磲赝飙殪霖霏霓霍霎錾辙辚臻冀餐遽氅瞟瞠瞰嚄嚆噤暾曈蹀蹅踶踹踵踽嘴踱蹄蹉蹁蹂螨蟒蟆螈螅螭螗螃螠螟噱器噪噬噫噻噼幪罹圜鹦赠默黔镖镗镘镚镛镜镝镞镠氇氆赞憩穑穆穄篝篚篥篮篡簉篦篪篷篙篱盥儒劓翱魉魈邀徼衡歙盦膨膪膳螣膦膙雕鲭鲮鲯鲰鲱鲲鲳鲴鲵鲷鲸鲺鲹鲻獴獭獬邂憝亸鹧磨廨赟癀瘭瘰廪瘿瘵瘴癃瘾瘸瘳斓麇麈凝辨辩嬴壅羲糙糗糖糕瞥甑燎燠燔燃燧燏濑濒濉潞澧澡澴激澹澥澶濂澼憷懒憾懈黉褰寰窸窿褶禧壁避嬖犟隰嬗鹨翯颡缰缱缲缳缴璨璩璐璪戴螫擤壕擦觳罄擢藉薹鞡鞠藏薷薰藐藓藁檬檑檄檐檩檀懋醢翳繄礁礅磷磴鹩霜霞龋龌豳壑黻瞭瞧瞬瞳瞵瞩瞪嚏曙嚅蹑蹒蹋蹈蹊蹓蹐蟥螬螵疃螳螺蟋蟑蟀嚎嚓羁罽罾嶷赡黜黝髁髀镡镢镣镤镥镦镧镨镩镪镫罅穗黏魏簧簌篾簃篼簏簇簖簋繁鼢黛儡鹪鼾皤魍徽艚龠爵繇貘邈貔臌朦臊膻臁臆臃鲼鲽鲾鳀鳁鳂鳃鳄鳅鳆鳇鳈鳉鳊獯螽燮鹫襄糜縻膺癍癌麋辫赢糟糠馘燥懑濡濮濞濠濯懦豁蹇謇邃襕襁臀檗甓臂擘孺隳嬷翼蟊鹬鍪骤鏊鳌鬶鬈鬃瞽藕鞯鞨鞭鞫鞧鞣藜藠藤藩鹲檫檵覆醪蹙礞礓礌燹餮瞿瞻曛颢曜躇蹦鹭蹢蹜蟛蟪蟠蟮嚚嚣鹮黠黟髅髂镬镭镯镰镱馥簠簟簪簦鼫鼬鼩雠艟翻臑鳍鳎鳏鳐鳑鹱鹰癞癔癜癖糨冁蹩瀑瀍瀌鎏懵襟璧戳彝邋攉攒鞲鞴藿蘧孽蘅警蘑藻麓攀醭醮醯礤酃霪霭黼曝嚯蹰蹶蹽蹼蹯蹴蹾蹲蹭蹿蹬蠖蠓蠋蟾蠊巅黢髋髌镲籀簸籁簿鳘齁魑艨鼗鳓鳔鳕鳗鳙鳚蟹颤靡癣麒鏖瓣蠃羸羹鳖爆瀚瀣瀛襦谶襞疆骥缵瓒鬓壤攘馨蘩蘖蘘醵醴霰颥酆耀矍曦躁躅蠕鼍嚼嚷巍巉黩黥镳镴黧籍纂鼯臜鳜鳝鳞鳟獾魔糯灌瀹瀵譬孀骧耰蠢瓘鼙醺礴礳霸露霹颦曩躏黯髓鼱鳡鳢癫麝赣夔爝灏禳鐾羼蠡耲耱懿韂蘸鹳蘼囊霾氍饕躔躐髑镵镶穰鳤瓤饔鬻鬟趱攫攥颧躜罐鼹鼷癯麟蠲矗蠹醾躞衢鑫灞襻纛鬣攮囔馕戆蠼爨齉